1111111111111
10C0C0C10C0C1
100100010C001
1P0100C0000E1
1111111111111
