111111111111
1P000010XCX1
1000001000E1
100X0000X001
100X0000X001
100X0000X001
100X0000X001
100X0000X001
100X0000X001
111111111111
