1111111111111111111111111111111111
1EX00000000000XC00000C0000X0000001
1010010100100000101001000000010101
10100100101010100010010X0000010101
1P00C00X0C00C0000000000000000000C1
1111111111111111111111111111111111
