1111111111111111111111111111111111
1E0000000000000C00000C000000000001
101001X100100000101001000X00010101
101001X010101010001001000X00010101
1P0090000C00C000000CC00000000000C1
1111111111111111111111111111111111
